#########################################################################
#########################################################################
########################                      #              ####       #
## ######### ###################### ######## # # ### ###### #    ## # # #
## ##   # ## ##                       #    # # # #        # #### ## # # #
## ## # # ## ## ################### # # #### # # # # ######    # ## # # #
## ## # # ## ## ##########          # #      # # # #     ##### #  # # # #
## ## # # ## ## ##       # ########## ######## # ####### #     #### # # #
## ## # # ## ## ## ##### #          #                  # # ###    # #   #
## ## # #  # ## ## #   # # ######## # ## # ########### # ######## # #####
## ## # ## # ## ## ### # # ######## # ## #    #      # #       ## #     #
## ## # ## # ## ##     #        ### # #  # ## # #### # # ######## ### # #
## ## # ## # ## ## ######### ## ### # #### ## # # ## # # ## #   #     # #
## ## # ##              # ## ## ##  #    # ## # #    # # ## # # ##### # #
## ## # ####### ## ###### ## ## ## ## #### #  # ###### # ## # # #     # #
##    #         ## ###### ##       ## ## # ####        # ## # # # ## ## #
##### ####### # ##        ## ## ##    ##      ##########      # # ## ## #
##    ####### # ############### ##### ## ###################### # ## ## #
## ##       # #                 #        #    ####            # # ## ## #
## ######## # ######## ################ ## ##    # ## ####### # # ## ## #
## ## # ### # # ###        ####       #    ## ## # ##       # # #  # ## #
## ## #     # # ### ###### #  # ##### ####### ## # ######## # # ## # ## #
## ## # ## ## # ### ## # # ## #    ## ##      ## #        # # # ## # ## #
## ## # ## ## #     ## # # ## #### ## ## #### ## # # ###### # # ## #### #
## ## #  # ## # ## ### # #       # ## ## #  # ## # # ###  # # # #  #    #
## ## #### ## # #      #   ### ### ## ## ## # #  # # ### ## # # # ## ####
## #       ## # ###### ####### ###### ##    # # ## #   # ## # # # ##    #
## ## ####### #                     # ####### # ## # ### #### # # ##### #
## ##       # ######## ##############         # ## #        # # #     # #
## ########## ######## ######################## ## ########## ###### ####
#########################################################################